{
"width": 10,
"height": 8,
"step": 20,
"tiles": [
[9, 9, 9, 9, 9, 9, 9, 9, 9, 9],
[9, 1, 1, 1, 1, 1, 1, 3, 1, 9],
[9, 1, 8, 6, 0, 4, 0, 2, 1, 9],
[9, 1, 0, 1, 1, 1, 1, 0, 1, 9],
[9, 1, 0, 7, 0, 8, 0, 0, 1, 9],
[9, 1, 0, 1, 8, 1, 1, 0, 1, 9],
[9, 1, 0, 0, 2, 0, 0, 5, 1, 9],
[9, 9, 9, 9, 9, 9, 9, 9, 9, 9]
]
}