{
"width": 9,
"height": 7,
"step": 999,
"tiles": [
[9, 9, 9, 9, 9, 9, 9, 9, 9],
[9, 1, 2, 4, 5, 6, 7, 8, 9],
[9, 10, 11, 0, 0, 0, 0, 0, 9],
[9, 0, 0, 0, 0, 0, 0, 0, 9],
[9, 0, 0, 0, 0, 0, 0, 0, 9],
[9, 3, 0, 0, 0, 0, 0, 0, 9],
[9, 9, 9, 9, 9, 9, 9, 9, 9]
]
}
