{
"width": 10,
"height": 8,
"step": 28,
"tiles": [
[9, 9, 9, 9, 9, 9, 9, 9, 9, 9],
[9, 1, 1, 1, 1, 1, 1, 1, 1, 9],
[9, 1, 7, 6, 7, 6, 7, 5, 1, 9],
[9, 1, 6, 1, 1, 1, 8, 8, 1, 9],
[9, 1, 7, 0, 2, 0, 8, 8, 1, 9],
[9, 1, 6, 1, 1, 1, 8, 8, 1, 9],
[9, 1, 3, 0, 0, 0, 8, 4, 1, 9],
[9, 9, 9, 9, 9, 9, 9, 9, 9, 9]
]
}