{
"width": 10,
"height": 8,
"step": 20,
"tiles": [
[9, 9, 9, 9, 9, 9, 9, 9, 9, 9],
[9, 1, 1, 1, 1, 1, 1, 1, 1, 9],
[9, 1, 3, 6, 7, 6, 7, 6, 1, 9],
[9, 1, 1, 1, 1, 1, 1, 7, 1, 9],
[9, 1, 6, 6, 6, 6, 2, 6, 1, 9],
[9, 1, 6, 2, 7, 1, 1, 1, 1, 9],
[9, 1, 6, 6, 6, 6, 6, 5, 1, 9],
[9, 9, 9, 9, 9, 9, 9, 9, 9, 9]
]
}