{
"width": 10,
"height": 8,
"step": 22,
"tiles": [
[9, 9, 9, 9, 9, 9, 9, 9, 9, 9],
[9, 1, 1, 1, 0, 8, 1, 1, 1, 9],
[9, 1, 3, 2, 0, 1, 0, 4, 1, 9],
[9, 1, 0, 1, 0, 1, 0, 1, 1, 9],
[9, 2, 0, 4, 0, 2, 0, 6, 1, 9],
[9, 1, 1, 0, 1, 0, 0, 1, 1, 9],
[9, 1, 8, 0, 1, 0, 7, 5, 1, 9],
[9, 9, 9, 9, 9, 9, 9, 9, 9, 9]
]
}