{
"width": 10,
"height": 8,
"step": 18,
"tiles": [
[9, 9, 9, 9, 9, 9, 9, 9, 9, 9],
[9, 1, 1, 1, 1, 1, 6, 2, 3, 9],
[9, 1, 2, 0, 4, 0, 6, 8, 2, 9],
[9, 1, 0, 1, 1, 1, 1, 0, 7, 9],
[9, 1, 0, 8, 0, 2, 8, 0, 1, 9],
[9, 1, 0, 1, 7, 1, 1, 1, 1, 9],
[9, 1, 0, 0, 0, 0, 0, 5, 1, 9],
[9, 9, 9, 9, 9, 9, 9, 9, 9, 9]
]
}