{
"width": 10,
"height": 8,
"step": 30,
"tiles": [
[9, 9, 9, 9, 9, 9, 9, 9, 9, 9],
[9, 1, 1, 1, 1, 1, 1, 1, 1, 9],
[9, 1, 0, 0, 6, 0, 7, 0, 1, 9],
[9, 1, 2, 8, 1, 1, 8, 2, 1, 9],
[9, 1, 0, 0, 0, 1, 0, 0, 1, 9],
[9, 1, 0, 1, 2, 1, 7, 6, 1, 9],
[9, 1, 3, 1, 0, 0, 6, 5, 1, 9],
[9, 9, 9, 9, 9, 9, 9, 9, 9, 9]
]
}