{
"width": 10,
"height": 8,
"step": 20,
"tiles": [
[9, 9, 9, 9, 9, 9, 9, 9, 9, 9],
[9, 0, 3, 2, 0, 4, 0, 0, 1, 9],
[9, 1, 1, 0, 1, 1, 1, 1, 1, 9],
[9, 0, 0, 7, 1, 5, 7, 0, 1, 9],
[9, 1, 2, 1, 1, 1, 1, 0, 1, 9],
[9, 1, 0, 0, 0, 0, 0, 0, 1, 9],
[9, 1, 8, 8, 8, 8, 8, 8, 1, 9],
[9, 9, 9, 9, 9, 9, 9, 9, 9, 9]
]
}