{
"width": 10,
"height": 8,
"step": 23,
"tiles": [
[9, 9, 9, 9, 9, 9, 9, 9, 9, 9],
[9, 1, 1, 1, 1, 1, 0, 3, 1, 9],
[9, 1, 1, 0, 6, 4, 6, 0, 1, 9],
[9, 1, 1, 0, 4, 6, 4, 1, 1, 9],
[9, 1, 0, 0, 1, 1, 1, 1, 1, 9],
[9, 1, 0, 2, 0, 0, 2, 0, 1, 9],
[9, 1, 0, 2, 0, 2, 0, 0, 5, 9],
[9, 9, 9, 9, 9, 9, 9, 9, 9, 9]
]
}
    