{
"width": 10,
"height": 8,
"step": 14,
"tiles": [
[9, 9, 9, 9, 9, 9, 9, 9, 9, 9],
[9, 1, 1, 1, 1, 1, 1, 1, 1, 9],
[9, 1, 0, 0, 7, 2, 0, 7, 1, 9],
[9, 1, 8, 1, 1, 1, 0, 0, 1, 9],
[9, 1, 0, 2, 8, 8, 8, 0, 1, 9],
[9, 1, 0, 1, 1, 8, 1, 0, 1, 9],
[9, 1, 3, 0, 2, 8, 0, 5, 1, 9],
[9, 9, 9, 9, 9, 9, 9, 9, 9, 9]
]
}