{
"width": 9,
"height": 7,
"step": 6,
"tiles": [
[9, 9, 9, 9, 9, 9, 9, 9, 9],
[9, 1, 1, 1, 1, 1, 1, 1, 9],
[9, 1, 3, 0, 0, 2, 0, 1, 9],
[9, 1, 0, 1, 2, 0, 0, 1, 9],
[9, 1, 0, 0, 0, 1, 5, 1, 9],
[9, 1, 1, 1, 1, 1, 1, 1, 9],
[9, 9, 9, 9, 9, 9, 9, 9, 9]
]
}
