{
"width": 10,
"height": 9,
"step": 32,
"tiles": [
[9, 9, 9, 9, 9, 9, 9, 9, 9, 9],
[9, 9, 9, 1, 0, 0, 5, 0, 9, 9],
[9, 9, 9, 1, 1, 1, 1, 11, 1, 9],
[9, 9, 9, 0, 8, 8, 0, 0, 3, 9],
[9, 9, 9, 8, 1, 8, 1, 0, 0, 9],
[9, 9, 9, 0, 0, 4, 8, 8, 1, 9],
[9, 10, 1, 8, 1, 8, 1, 0, 9, 9],
[9, 0, 0, 0, 0, 0, 4, 0, 9, 9],
[9, 9, 9, 9, 9, 9, 9, 9, 9, 9]
]
}
