{
"width": 11,
"height": 7,
"step": 22,
"tiles": [
[9, 9, 9, 9, 9, 9, 9, 9, 9, 9],
[9, 3, 1, 10, 0, 2, 1, 1, 1, 9],
[9, 0, 2, 8, 2, 0, 11, 0, 1, 9],
[9, 2, 0, 2, 0, 2, 2, 0, 5, 9],
[9, 0, 2, 0, 2, 0, 2, 2, 0, 9],
[9, 1, 0, 2, 0, 2, 0, 1, 9, 9],
[9, 9, 9, 9, 9, 9, 9, 9, 9, 9]
]
}
