{
"width": 9,
"height": 10,
"step": 11,
"tiles": [
[9, 9, 9, 9, 5, 9, 9, 9, 9],
[9, 0, 0, 0, 4, 0, 0, 0, 9],
[9, 0, 0, 0, 4, 0, 0, 0, 9],
[9, 0, 0, 0, 4, 0, 0, 0, 9],
[9, 0, 0, 0, 4, 0, 0, 0, 9],
[9, 0, 0, 0, 4, 0, 0, 0, 9],
[9, 0, 0, 0, 4, 0, 0, 0, 9],
[9, 0, 0, 0, 4, 0, 0, 0, 9],
[9, 0, 0, 0, 4, 0, 0, 0, 9],
[9, 0, 0, 0, 3, 0, 0, 0, 9],
[9, 9, 9, 9, 9, 9, 9, 9, 9]
]
}