{
"width": 10,
"height": 9,
"step": 32,
"tiles": [
[9, 9, 9, 9, 9, 9, 9, 9, 9, 9],
[9, 9, 9, 9, 9, 5, 0, 1, 9, 9],
[9, 9, 9, 9, 9, 0,11, 0, 1, 9],
[9, 9, 0,10, 1, 2, 2, 2, 1, 9],
[9, 9, 4, 2, 0, 4, 2, 0, 9, 9],
[9, 9, 0, 1, 4, 0, 0, 3, 9, 9],
[9, 1, 6, 1, 1, 7, 1, 1, 9, 9],
[9, 1, 7, 6, 7, 6, 1, 9, 9, 9],
[9, 9, 9, 9, 9, 9, 9, 9, 9, 9]
]
}