{
"width": 10,
"height": 8,
"step": 13,
"tiles": [
[9, 9, 9, 9, 9, 9, 9, 9, 9, 9],
[9, 1, 1, 1, 1, 1, 1, 1, 1, 9],
[9, 1, 4, 0, 4, 0, 0, 6, 1, 9],
[9, 1, 0, 1, 6, 8, 1, 7, 1, 9],
[9, 1, 4, 1, 8, 4, 1, 6, 1, 9],
[9, 1, 0, 0, 2, 0, 1, 7, 1, 9],
[9, 1, 1, 1, 3, 1, 1, 5, 1, 9],
[9, 9, 9, 9, 9, 9, 9, 9, 9, 9]
]
}