{
"width": 8,
"height": 9,
"step": 23,
"tiles": [
[9, 9, 9, 9, 9, 9, 9, 9],
[9, 9, 9, 1, 0, 5, 1, 9],
[9, 9, 9, 0,11, 2, 0, 9],
[9, 3, 9, 7, 0, 2, 0, 9],
[9, 0, 9, 0, 7, 0, 7, 9],
[9, 4, 1, 2, 2, 2, 2, 9],
[9, 7, 0, 7, 0, 0, 7, 9],
[9, 9, 9, 9, 9, 9,10, 9],
[9, 9, 9, 9, 9, 9, 9, 9]
]
}
