{
"width": 9,
"height": 10,
"step": 42,
"tiles": [
[9, 9, 9, 9, 9, 9, 9, 9, 9],
[9, 9, 0, 3, 0, 9, 9, 9, 9],
[9, 1, 2, 2, 2, 1, 9, 9, 9],
[9, 0, 0, 0,10, 1, 1, 1, 9],
[9, 1, 6, 2, 0, 0, 1, 1, 9],
[9, 1, 4, 1, 2, 2, 0, 0, 9],
[9, 1, 0, 0, 2, 0, 4, 1, 9],
[9, 1, 1, 1, 1,11, 2, 0, 9],
[9, 9, 9, 9, 1, 0, 5, 9, 9],
[9, 9, 9, 9, 9, 9, 9, 9, 9]
]
}
