{
"width": 9,
"height": 8,
"step": 24,
"tiles": [
[9, 9, 9, 9, 9, 9, 9, 9, 9],
[9, 1, 0, 0, 0, 0, 1, 1, 9],
[9, 1, 4, 9, 8, 8, 0, 0, 9],
[9, 0, 8, 9, 9, 2, 2, 2, 9],
[9, 0, 0, 9, 9, 0, 8, 0, 9],
[9, 3, 0, 9, 1, 0, 4, 0, 9],
[9, 9, 9, 9, 1, 5, 0, 4, 9],
[9, 9, 9, 9, 9, 9, 9, 9, 9]
]
}
