{
"width": 11,
"height": 8,
"step": 33,
"tiles": [
[9, 9, 9, 9, 9, 5, 9, 9, 9, 9, 9],
[9, 1, 1, 1, 0, 0, 0, 1, 1, 1, 9],
[9, 1, 1, 1, 2,11, 2, 1, 1, 1, 9],
[9, 1, 2, 1, 2, 0, 0, 1, 0, 1, 9],
[9, 2, 0, 0, 2, 2, 2, 0, 0,10, 9],
[9, 0, 2, 2, 2, 0, 0, 2, 2, 0, 9],
[9, 9, 3, 0, 2, 0, 0, 2, 0, 9, 9],
[9, 9, 9, 9, 9, 9, 9, 9, 9, 9, 9]
]
}