{
"width": 16,
"height": 8,
"step": 13,
"tiles": [
[9, 9, 9, 9, 1, 1, 1, 1, 1, 1, 1, 9, 9, 9, 9, 9],
[9, 9, 9, 9, 1, 3, 0, 1, 0, 5, 1, 9, 9, 9, 9, 9],
[9, 9, 9, 1, 0, 0, 2, 0, 2,11, 0, 1, 9, 9, 9, 9],
[9, 9, 9, 1, 2, 0, 1, 1, 1, 4, 2, 1, 9, 9, 9, 9],
[9, 9, 9, 1, 6, 2, 6,10, 6, 2, 6, 1, 9, 9, 9, 9],
[9, 9, 9, 9, 1, 7, 2, 7, 2, 7, 1, 9, 9, 9, 9, 9],
[9, 9, 9, 9, 1, 1, 1, 1, 1, 1, 1, 9, 9, 9, 9, 9],
[9, 9, 9, 9, 9, 9, 9, 9, 9, 9, 9, 9, 9, 9, 9, 9]
]
}
