{
"width": 10,
"height": 8,
"step": 9,
"tiles": [
[9, 9, 9, 9, 9, 9, 9, 9, 9, 9],
[9, 1, 1, 1, 1, 1, 1, 1, 1, 9],
[9, 1, 3, 0, 0, 2, 0, 1, 1, 9],
[9, 1, 0, 1, 0, 2, 0, 0, 1, 9],
[9, 1, 0, 0, 1, 0, 2, 0, 5, 9],
[9, 1, 1, 1, 1, 1, 1, 1, 1, 9],
[9, 9, 9, 9, 9, 9, 9, 9, 9, 9],
[9, 9, 9, 9, 9, 9, 9, 9, 9, 9]
]
}
