{
"width": 11,
"height": 9,
"step": 22,
"tiles": [
[9, 9, 9, 9, 9, 9, 9, 9, 9, 9, 9],
[9, 1, 1, 1, 1, 1, 1, 1, 1, 1, 9],
[9, 1, 3, 0, 0, 0, 1, 0, 0, 1, 9],
[9, 1, 0, 1, 0, 0, 1, 2, 0, 0, 9],
[9, 1, 0, 0, 2, 1, 1, 0, 1, 0, 9],
[9, 1, 1, 1, 0, 2, 0, 0, 1, 0, 9],
[9, 1, 0, 0, 0, 0, 0, 0, 1, 0, 9],
[9, 1, 0, 1, 0, 1, 1, 1, 5, 0, 9],
[9, 9, 9, 9, 9, 9, 9, 9, 9, 9, 9]
]
}
