{
"width": 12,
"height": 10,
"step": 35,
"tiles": [
[9, 9, 9, 9, 9, 9, 9, 9, 9, 9, 9, 9],
[9, 0, 0, 0, 1, 1, 1, 1, 0, 0, 0, 9],
[9, 0, 3, 0, 0, 2, 0, 0, 0, 4, 0, 9],
[9, 1, 1, 1, 0, 1, 1, 1, 0, 1, 1, 9],
[9, 0, 0, 2, 0, 0, 2, 0, 0, 0, 0, 9],
[9, 0, 4, 1, 1, 0, 1, 1, 0, 1, 0, 9],
[9, 1, 0, 0, 0, 2, 0, 0, 0, 1, 0, 9],
[9, 1, 1, 0, 1, 1, 1, 0, 0, 1, 0, 9],
[9, 0, 0, 0, 0, 0, 0, 0, 5, 1, 0, 9],
[9, 9, 9, 9, 9, 9, 9, 9, 9, 9, 9, 9]
]
}